12 12
5 4
2
1 1
10 10
1 1 1 1 1 1 1 1 1 1 1 1
1 0 0 0 0 1 1 0 0 0 0 1
1 0 1 1 0 0 0 0 1 1 0 1
1 0 1 1 0 1 1 0 1 1 0 1
1 0 0 0 0 0 0 0 0 0 0 1
1 0 1 1 1 1 1 1 1 1 0 1
1 0 0 0 0 1 1 0 0 0 0 1
1 1 0 1 0 0 0 0 1 0 1 1
1 0 0 1 0 1 1 0 1 0 0 1
1 0 1 1 0 1 1 0 1 1 0 1
1 0 0 0 0 0 0 0 0 0 0 1
1 1 1 1 1 1 1 1 1 1 1 1
