11 12
2
5 4
2
1 1
9 10
1 1 1 1 1 1 1 1 1 1 1
1 0 3 0 0 1 0 4 0 0 1
1 0 1 1 0 0 0 1 1 0 1
1 0 1 1 0 1 0 1 1 0 1
1 0 0 0 0 0 0 0 0 0 1
1 0 1 1 1 1 1 1 1 0 1
1 0 0 0 0 1 0 0 0 0 1
1 1 0 1 0 0 0 1 0 1 1
1 0 5 1 0 1 0 1 6 0 1
1 0 1 1 0 1 0 1 1 0 1
1 0 0 0 0 0 0 0 0 0 1
1 1 1 1 1 1 1 1 1 1 1
