19 20
2
9 8 
4
1 1
1 17
17 1
17 17
1 1 1 1 1 1 1 1 1 1 1 1 1 1 1 1 1 1 1
1 0 0 0 0 0 0 1 1 1 1 1 0 0 0 0 0 0 1
1 0 1 1 0 1 0 0 0 0 0 0 0 1 0 1 1 0 1
1 0 1 0 0 1 0 1 1 1 1 1 0 1 0 0 1 0 1
1 0 0 0 1 1 0 1 0 0 0 1 0 1 1 0 0 0 1
1 1 1 0 0 0 0 0 0 1 0 0 0 0 0 0 1 1 1
1 0 0 0 1 1 1 0 1 1 1 0 1 1 1 0 0 0 1
1 0 1 1 1 1 0 0 0 1 0 0 0 1 1 1 1 0 1
1 0 0 0 0 0 0 1 0 0 0 1 0 0 0 0 0 0 1
1 1 1 1 0 1 1 1 1 1 1 1 1 1 0 1 1 1 1
1 0 0 0 0 0 0 0 0 0 0 0 0 0 0 0 0 0 1
1 0 1 1 1 1 0 1 0 1 0 1 0 1 1 1 1 0 1
1 0 1 0 0 0 0 1 0 1 0 1 0 0 0 0 1 0 1
1 0 0 0 1 1 1 1 0 0 0 1 1 1 1 0 0 0 1
1 1 1 0 1 1 0 0 0 1 0 0 0 1 1 0 1 1 1
1 0 0 0 0 1 0 1 0 1 0 1 0 1 0 0 0 0 1
1 0 1 1 0 1 0 1 0 0 0 1 0 1 0 1 1 0 1
1 0 0 1 0 0 0 1 1 1 1 1 0 0 0 1 0 0 1
1 1 0 0 0 1 0 0 0 0 0 0 0 1 0 0 0 1 1
1 1 1 1 1 1 1 1 1 1 1 1 1 1 1 1 1 1 1