7 7
2
1 1
0
1 1 1 1 1 1 1
1 5 0 7 0 6 1
1 0 1 0 1 0 1
1 0 0 0 0 0 1
1 0 1 0 1 0 1
1 4 0 0 0 3 1
1 1 1 1 1 1 1
