19 20
4
9 8 
4
1 1
1 17
17 1
17 17
1 1 1 1 1 1 1 1 1 1 1 1 1 1 1 1 1 1 1
1 0 0 0 0 0 0 1 1 1 1 1 0 0 0 0 0 0 1
1 0 1 1 0 1 0 0 0 7 0 0 0 1 0 1 1 0 1
1 0 1 3 0 1 0 1 1 1 1 1 0 1 0 6 1 0 1
1 0 0 0 1 1 0 1 0 4 0 1 0 1 1 0 0 0 1
1 1 1 0 0 0 0 0 0 1 0 0 0 0 0 0 1 1 1
1 4 0 0 1 1 1 0 1 1 1 0 1 1 1 0 0 3 1
1 0 1 1 1 1 0 0 0 1 0 0 0 1 1 1 1 0 1
1 0 0 7 0 0 0 1 0 0 0 1 0 0 0 7 0 0 1
1 1 1 1 0 1 1 1 1 1 1 1 1 1 0 1 1 1 1
1 0 0 0 0 0 0 0 0 0 0 0 0 0 0 0 0 0 1
1 0 1 1 1 1 0 1 0 1 0 1 0 1 1 1 1 0 1
1 0 1 5 0 0 0 1 0 1 0 1 0 0 0 4 1 0 1
1 0 0 0 1 1 1 1 0 7 0 1 1 1 1 0 0 0 1
1 1 1 0 1 1 0 0 0 1 0 0 0 1 1 0 1 1 1
1 0 0 0 0 1 0 1 0 1 0 1 0 1 0 0 0 0 1
1 0 1 1 0 1 0 1 0 6 0 1 0 1 0 1 1 0 1
1 0 4 1 0 0 0 1 1 1 1 1 0 0 0 1 5 0 1
1 1 0 0 0 1 0 0 0 3 0 0 0 1 0 0 0 1 1
1 1 1 1 1 1 1 1 1 1 1 1 1 1 1 1 1 1 1