20 20
10 8 
4
1 1
1 17
18 1
18 17
1 1 1 1 1 1 1 1 1 1 1 1 1 1 1 1 1 1 1 1
1 0 0 0 0 0 0 1 1 1 1 1 1 0 0 0 0 0 0 1
1 0 1 1 0 1 0 0 0 0 0 0 0 0 1 0 1 1 0 1
1 0 1 0 0 1 0 1 1 1 1 1 1 0 1 0 0 1 0 1
1 0 0 0 1 1 0 1 0 0 0 0 1 0 1 1 0 0 0 1
1 1 1 0 0 0 0 0 0 1 1 0 0 0 0 0 0 1 1 1
1 0 0 0 1 1 1 0 1 1 1 1 0 1 1 1 0 0 0 1
1 0 1 1 1 1 0 0 0 1 1 0 0 0 1 1 1 1 0 1
1 0 0 0 0 0 0 1 0 0 0 0 1 0 0 0 0 0 0 1
1 1 1 1 0 1 1 1 1 1 1 1 1 1 1 0 1 1 1 1
1 0 0 0 0 0 0 0 0 0 0 0 0 0 0 0 0 0 0 1
1 0 1 1 1 1 0 1 0 1 1 0 1 0 1 1 1 1 0 1
1 0 1 0 0 0 0 1 0 1 1 0 1 0 0 0 0 1 0 1
1 0 0 0 1 1 1 1 0 0 0 0 1 1 1 1 0 0 0 1
1 1 1 0 1 1 0 0 0 1 1 0 0 0 1 1 0 1 1 1
1 0 0 0 0 1 0 1 0 1 1 0 1 0 1 0 0 0 0 1
1 0 1 1 0 1 0 1 0 0 0 0 1 0 1 0 1 1 0 1
1 0 0 1 0 0 0 1 1 1 1 1 1 0 0 0 1 0 0 1
1 1 0 0 0 1 0 0 0 0 0 0 0 0 1 0 0 0 1 1
1 1 1 1 1 1 1 1 1 1 1 1 1 1 1 1 1 1 1 1